3 3 3 3 3 3 3 3 3 3 3 3 3 3 3 3   
6 6 6 6 6 6 6 6 6 1 0 0 0 0 0 3
6 6 6 6 6 6 6 6 1 1 0 0 0 0 0 3
6 6 6 6 6 6 6 1 1 0 0 0 0 0 0 3
1 1 1 1 1 1 1 1 0 0 0 0 0 0 0 3
6 3 3 6 6 6 3 6 3 3 3 3 3 3 3 3 
3 3 3 3 3 3 3 3 3 6 6 3 3 3 3 3 
3 3 3 3 3 3 3 3 3 3 3 3 3 3 3 3
3 3 3 3 3 3 3 6 3 3 3 6 3 3 3 6 
0 1 1 1 1 1 1 1 1 6 3 3 3 3 6 3
0 0 3 3 3 3 3 3 6 6 6 6 6 3 3 3
3 3 3 3 3 3 3 3 3 3 3 3 3 3 3 3 