2 2 2 2 2 2 2 2 2 2 2 2 2 2 2 2 6 6 6 6 6 6 6 6 6 6 6 6 6 6 6 6 6 6 6 6 6 6 6 6 6 6 6 6 6 6 6 6 1 1 1 1 1 1 1 1 1 1 1 1 1 1 1 1 
2 2 2 2 2 2 2 2 2 2 2 2 2 2 2 2 6 3 3 3 6 3 3 3 3 3 3 3 3 3 3 3 6 6 6 6 6 6 6 6 6 1 0 0 0 0 0 3 1 1 0 0 0 0 0 0 0 0 0 0 0 0 1 1
2 2 2 2 2 2 2 2 2 2 2 2 2 2 2 2 6 3 3 3 3 3 3 3 3 3 3 6 3 3 3 3 6 6 6 6 6 6 6 6 1 1 0 0 0 3 0 3 1 1 0 0 0 0 0 0 0 0 0 0 0 0 1 1
2 2 2 2 2 2 2 2 2 2 2 2 2 2 2 2 6 3 6 3 3 3 3 3 3 6 3 6 6 3 3 3 6 6 6 6 6 6 6 1 1 0 0 0 0 0 0 3 1 1 0 0 0 0 0 0 0 0 0 0 0 0 1 1
2 2 2 2 2 2 2 2 2 2 2 2 2 2 2 2 6 3 3 3 6 3 3 3 3 3 3 6 6 3 3 3 1 1 1 1 1 1 1 1 0 0 0 0 0 0 0 3 1 1 0 0 0 0 0 0 0 0 0 0 0 0 1 1
2 2 2 2 2 2 2 2 2 2 2 2 2 2 2 2 6 3 6 3 3 3 3 3 3 3 3 6 3 3 3 3 6 3 3 6 6 6 3 6 3 3 3 3 3 3 3 3 1 1 1 0 0 0 0 0 0 0 0 0 0 1 1 1
2 2 2 2 2 2 2 2 2 2 2 2 2 2 2 2 6 3 3 3 3 3 3 6 3 3 3 6 3 3 3 3 6 3 3 3 3 3 3 3 3 6 6 3 3 3 3 3 1 1 1 0 0 0 0 0 0 0 0 0 0 1 1 1
2 2 2 2 2 2 2 2 2 2 2 2 2 2 2 2 6 3 3 3 3 3 3 6 3 3 3 6 3 3 3 3 6 3 3 3 3 3 3 3 3 3 3 3 3 3 3 3 1 1 1 1 0 0 0 0 0 0 0 0 1 1 1 1
2 2 2 2 2 2 2 2 2 2 2 2 2 2 2 2 6 3 3 6 3 6 6 3 6 6 6 6 3 6 3 3 6 3 3 3 3 3 3 6 3 3 3 6 3 3 3 6 1 1 1 1 1 0 0 0 0 0 0 1 1 1 1 1
2 2 2 2 2 2 2 2 2 2 2 2 2 2 2 2 6 3 6 3 3 6 3 3 3 3 3 6 6 3 3 3 6 0 0 0 1 1 1 1 1 6 3 3 3 3 6 3 1 1 1 1 1 1 1 0 0 1 1 1 1 1 1 1
2 2 2 2 2 2 2 2 2 2 2 2 2 2 2 2 6 3 6 3 3 3 3 3 3 3 3 6 3 3 3 3 0 0 3 3 3 3 3 3 6 6 6 6 6 3 3 3 1 1 1 1 1 1 1 0 0 1 1 1 1 1 1 1
2 2 2 2 2 2 2 2 2 2 2 2 2 2 2 2 6 3 3 3 3 3 3 3 3 3 3 6 3 3 3 3 6 3 3 3 3 3 3 3 3 3 3 3 3 3 3 3 1 1 1 1 1 1 1 0 0 1 1 1 1 1 1 1
1 1 1 1 1 1 1 1 1 1 1 1 1 1 1 1 4 4 4 4 4 4 3 0 0 3 4 4 4 4 4 4 1 1 1 1 1 1 1 1 1 1 1 1 1 1 1 1 1 1 1 1 1 1 1 0 0 1 1 1 1 1 1 1
1 3 3 3 3 3 3 0 0 0 0 0 0 0 0 1 4 4 4 4 4 4 4 0 0 4 4 4 4 4 4 4 1 1 1 1 1 1 1 1 1 1 1 1 1 1 1 1 1 1 1 1 1 1 1 1 0 1 1 1 1 1 1 1
1 3 3 3 3 3 3 0 0 0 4 4 4 4 4 1 4 4 4 4 4 4 4 0 0 4 4 4 4 4 4 4 1 1 1 1 1 1 1 1 1 1 1 1 1 1 1 1 1 1 1 1 1 1 1 1 0 0 1 1 1 1 1 1
1 3 0 0 0 3 3 3 0 0 0 4 4 4 4 1 4 4 4 4 4 4 4 0 0 4 4 4 4 4 4 4 1 1 1 1 1 1 1 1 1 1 1 1 1 1 1 1 1 1 1 1 1 1 1 1 3 5 1 1 1 1 1 1
1 3 3 0 0 0 3 0 0 0 0 0 1 1 1 1 1 4 4 4 4 4 4 0 0 4 4 4 4 4 4 4 1 1 1 1 1 1 1 1 1 1 1 1 1 1 1 1 1 1 1 1 1 1 1 1 0 0 1 1 1 1 1 1
1 0 0 0 0 0 0 0 0 0 0 0 0 0 0 0 0 0 0 0 0 0 0 0 0 0 0 0 0 0 0 0 0 0 0 0 0 0 0 0 0 0 0 0 0 0 0 0 0 0 5 0 0 5 3 0 3 0 0 1 1 1 1 1
1 0 0 0 0 0 0 0 0 0 0 0 0 0 0 0 0 0 0 0 0 0 0 0 0 0 0 0 0 0 0 0 0 0 0 0 0 0 0 0 0 0 0 0 0 0 0 0 0 5 3 5 0 0 5 0 0 3 0 1 1 1 1 1
1 4 4 0 0 0 0 0 0 0 1 1 1 1 1 1 1 4 4 4 4 4 4 0 0 4 4 4 4 4 4 4 1 1 1 1 1 1 1 1 1 1 1 1 1 1 1 1 1 1 1 1 1 1 1 0 0 0 0 0 1 1 1 1
1 4 0 0 0 0 4 0 0 0 4 4 4 4 4 4 4 4 4 4 4 4 4 0 0 4 4 4 4 4 4 4 1 1 1 1 1 1 1 1 1 1 1 1 1 1 1 1 1 1 1 1 1 1 1 1 1 0 0 1 1 1 1 1
1 1 4 0 0 4 0 0 0 1 4 4 4 4 4 4 4 4 4 4 4 4 4 0 0 4 4 4 4 4 4 4 1 1 1 1 1 1 1 1 1 1 1 1 1 1 1 1 1 1 1 1 1 1 1 1 1 1 1 1 1 1 1 1
1 4 1 4 0 0 0 0 0 1 4 4 4 4 4 4 4 4 4 4 4 4 4 0 0 4 4 4 4 4 4 4 1 1 1 1 1 1 1 1 1 1 1 1 1 1 1 1 1 1 1 1 1 1 1 1 1 1 1 1 1 1 1 1
1 1 1 1 1 1 0 1 1 1 4 4 4 4 4 4 4 4 4 4 4 4 5 0 0 5 4 4 4 4 4 4 1 1 1 1 1 1 1 1 1 1 1 1 1 1 1 1 1 1 1 1 1 1 1 1 1 1 1 1 1 1 1 1
2 2 2 2 2 2 5 5 2 2 2 2 2 2 2 2 2 2 2 2 2 2 2 0 4 4 2 2 2 2 2 2 2 2 2 2 2 2 2 2 2 2 2 2 2 2 2 2 2 2 2 2 2 2 2 2 2 2 2 2 2 2 2 2
2 5 5 5 5 2 5 5 2 2 2 2 2 2 2 2 2 2 2 2 2 2 5 5 5 2 2 2 2 2 2 2 2 2 2 2 2 2 2 2 2 2 2 2 2 2 2 2 2 2 2 2 2 5 5 5 5 5 5 5 5 5 5 2
2 5 5 5 5 2 5 5 2 2 2 2 2 2 2 2 2 2 2 2 2 5 5 5 5 2 2 2 2 2 2 2 2 2 2 2 2 2 2 2 2 2 2 2 2 2 2 2 2 2 2 2 5 5 5 5 5 5 5 5 5 5 5 2
2 5 5 5 5 2 5 5 2 2 2 2 2 2 2 2 2 2 2 2 2 5 5 5 5 5 2 2 2 2 2 2 2 2 2 2 2 2 2 2 2 2 2 2 2 2 2 2 2 2 2 2 5 5 5 5 5 5 5 5 5 5 5 2
2 5 5 5 2 2 5 5 2 2 2 2 2 2 2 2 2 2 2 2 5 5 5 5 5 5 5 2 2 2 2 2 2 2 2 2 2 2 2 2 2 2 2 2 2 2 2 2 2 2 2 2 5 5 5 5 5 5 5 5 5 5 5 2
2 2 5 5 2 2 5 5 2 2 2 2 2 2 2 2 2 2 2 2 5 5 5 5 5 5 5 5 5 5 5 5 5 5 5 5 5 5 5 5 5 5 5 5 5 5 5 5 5 5 5 5 5 5 5 5 5 5 5 5 5 5 5 2
2 2 5 5 2 2 5 5 2 2 2 2 2 2 2 2 2 2 2 2 5 5 5 5 5 5 5 5 2 2 2 2 5 5 5 5 5 5 5 5 5 5 5 5 5 5 5 5 5 5 5 5 5 5 5 5 5 5 5 5 5 5 5 2
2 2 2 5 5 5 5 5 2 2 2 2 2 2 2 2 2 2 2 2 2 2 5 5 5 5 5 2 2 2 2 2 2 2 2 2 2 5 5 5 2 2 2 2 2 2 2 2 2 2 2 2 5 5 5 5 5 5 5 5 5 5 5 2
2 2 2 2 2 2 2 2 2 2 2 2 2 2 2 2 2 2 2 2 2 5 5 5 5 5 5 5 2 2 2 2 2 2 2 2 5 5 5 2 2 2 2 2 2 2 2 2 2 2 2 2 5 5 5 5 5 5 5 5 5 5 5 2
2 2 2 2 2 2 2 2 2 2 2 2 2 2 2 2 2 2 2 2 5 5 5 5 5 5 5 5 5 2 2 2 2 2 2 5 5 5 5 5 2 2 2 2 2 2 2 2 2 2 2 2 5 5 5 5 5 5 5 5 5 5 5 2
2 2 2 2 2 2 2 2 2 2 2 2 2 2 2 2 2 2 2 2 2 2 2 2 2 2 2 2 2 2 2 2 2 2 2 5 5 5 5 5 2 2 2 2 2 2 2 2 2 2 2 2 2 5 5 5 5 5 5 5 5 5 5 2
2 2 2 2 2 2 2 2 2 2 2 2 2 2 2 2 2 2 2 2 2 2 2 2 2 2 2 2 2 2 2 2 2 2 2 2 2 2 2 2 2 2 2 2 2 2 2 2 2 2 2 2 2 2 2 2 2 2 2 2 2 2 2 2